10000000000000000000000000000000
00000009999000000000000000000000
00000009999000006000000000000000
00000009999000000000000000000000
00000000000000000000000000000002
